NO      maps/textures/no_texture
SO      maps/textures/so_texture
F 220,100,0
WE      maps/textures/we_texture
C 225,30,0
EA      maps/textures/ea_texture



11111111
100N1001
11111111
