SO         ./textures/Wall7.xpm   
WE ./textures/Wall4.xpm
NO ./textures/Wall2.xpm
EA ./textures/Wall8.xpm

C                                   0,0,0          
F 220,100,0        

11111111111111
10000000000001
10000000000001
10000000000001
10000000000001
1N000000000001
10000000000001
1            1

10000000000001
10000000000001
10000000000001
11111111111111

