NO /home/boenkhja/cub3D/cub3d_tests/maps/textures/no_texture
SO /home/boenkhja/cub3D/cub3d_tests/maps/textures/so_texture
WE /home/boenkhja/cub3D/cub3d_tests/maps/textures/we_texture
EA /home/boenkhja/cub3D/cub3d_tests/maps/textures/ea_texture
F 220,100,0
C 225,30,0

111111111111
100000000001
101111111101
101000000101
101011010101
101010N10101
101011010101
101000000101
101111111101
100000000001
111111111111
