NO
SO /home/boenkhja/cub3D/cub3d_tests/maps/textures/so_texture
WE /home/boenkhja/cub3D/cub3d_tests/maps/textures/we_texture
EA /home/boenkhja/cub3D/cub3d_tests/maps/textures/ea_texture
F 220,100,0
C 225,30,0

   11111111
   1      1
   1  N   1
   1      1
1111      1111
1            1
1            1
1111111111111
